Bahrain Economic Development Board	Bahrain
Blake, Cassels & Graydon - Bahrain	Bahrain
Bonyan International S.P.C	Bahrain
Investment & Trading (Gulf) Enterprises Limited B.S.C. (c)	Bahrain
Growthgate Capital Corporation BSC(c)	Bahrain
Mercure Grand Hotel Seef	Bahrain
Gulf Air B.S.C. (c)	Bahrain
Mirza Al Helli & Sons B.S.C	Bahrain
Hiralal Ramji Kalidas & Jewellery Company W.L.L	Bahrain
Jacobs GIBB Limited - Bahrain	Bahrain
SICO Funds Services Company B.S.C. (c)	Bahrain
Ascentech Telecom WLL	Bahrain
Naseef & Khan Saheb Abdulhussain & Brothers WLL	Bahrain
Alsayed Jamal Alhashimi & Sons Company	Bahrain
Raouf Contracting and Fabrication Est.	Bahrain
Mimar Architecture & Engineering	Bahrain
Alfouz Contracting Company W.L.L	Bahrain
Universal Agriculture BSC Closed	Bahrain
Memac Ogilvy & Mather WLL	Bahrain
Comsip - Al A'ali Company W.L.L.	Bahrain
Nofa Marine Services Co W.L.L	Bahrain
Kanoo Power Solutions	Bahrain
Bukamal	Bahrain
Bridge Industrial Services Company WLL	Bahrain
Bahrain Chamber for Dispute Resolution	Bahrain
Afaaq Al Khalij Excavation & Building Equipments Rental	Bahrain
Mohsin Haji Ali Trading Group	Bahrain
G.P. Zachariades (Overseas) Ltd	Bahrain
Syed Junaid Alam W.L.L	Bahrain
Rimal Venture Company WLL	Bahrain
Coloration Systems Company	Bahrain
Al Dasma Contracting and Maintenance Establishment	Bahrain
Bareeq Al Retaj Real Estate Services W.L.L	Bahrain
Rawan Engineering	Bahrain
Al Oraibi & Al Mulla Advocates & Legal Consultants	Bahrain
Impact Interiors W.L.L	Bahrain
United Insurance Company BSC	Bahrain
AMFA Holding Company L.L.C	Bahrain
National Investment & Reconstruction Company S.A.E.	Egypt
Tourism Urbanization Company S.A.E.	Egypt
Helmy, Hamza & Partners	Egypt
Nile Clothing Company SAE	Egypt
Drexel Oilfield Equipment (Egypt)	Egypt
AMA Arab Environment Company	Egypt
Amreyah Cement Company	Egypt
Assiut Oil Refining Company	Egypt
Misr for Central Clearing, Depository and Registry	Egypt
Smart Villages Development And Management Company	Egypt
Cairo National Automotive	Egypt
The General Egyptian Warehouses Company	Egypt
Educational Projects Company	Egypt
Egyptian Ship Repairs and Building Company	Egypt
El Nasr Wool & Selected Textiles Company	Egypt
Energya Industries	Egypt
Misr Glass Manufacturing Company S.A.E.	Egypt
Masria Card	Egypt
Mechanical Construction Engineers Company	Egypt
Iso Termica Contracting L.L.C.	Egypt
Renad Advertising Agency	Egypt
Enany for Real Estate Investment	Egypt
Global Consolidated Contractors	Egypt
Vimov	Egypt
Cold Alex Company for Food Processing	Egypt
New Tech	Egypt
Arabian Telecontrol and Engineering Center	Egypt
Dr Mohammed Mahmoud El Sayed Legal Accountants and Consultant	Egypt
Speed Authorized Translation	Egypt
Hill International (North Africa), Ltd.	Egypt
Misalla Industrial Services Company	Egypt
Perfect Company	Egypt
Mas Company	Egypt
